#CAMERA
NEAR -1.0
FAR 1.0
FOV 1.0
SPEED 10.0

Width: 16
Height: 9
Horizontal wall: 14
Player: 3
6 1 1 1 1 1 1 1 1 1 1 1 1 1 1 7 
10 0 0 0 0 0 0 0 0 0 0 0 0 0 0 11
10 0 0 0 0 0 0 12 0 0 0 0 0 0 0 11
10 0 0 0 0 0 0 0 0 0 0 0 0 0 0 11
10 0 2 0 0 0 0 0 0 0 0 0 0 5 0 11
10 0 0 0 0 0 13 0 0 0 0 0 0 0 0 11
10 0 0 0 0 0 13 0 0 0 12 0 0 0 0 11
10 0 0 0 0 0 13 0 0 0 0 0 0 0 0 11
8 1 1 1 1 1 1 1 1 1 1 1 1 1 1 9
Star: 11 14 17