#CAMERA
NEAR -1.0
FAR 1.0
FOV 1.0
SPEED 10.0

Width: 35
Height: 22
Horizontal wall: 108
Player: 3
Target: 5
Spawn: 3
Obstacle: 16
2 2 2 2 2 2 2 2 2 2 2 2 2 2 2 2 2 2 2 2 2 2 2 2 2 2 2 2 2 2 2 2 2 2 2 
2 2 2 2 2 2 2 2 2 2 2 2 2 2 2 2 2 2 2 2 2 2 2 2 2 2 2 2 2 2 2 2 2 2 2 
6 1 1 1 1 1 1 1 1 1 1 1 1 1 1 1 1 1 1 1 1 1 1 1 7 6 1 1 1 7 6 1 1 1 7
10 0 0 0 0 0 0 0 0 0 0 0 0 0 0 0 0 0 0 0 13 22 22 22 11 10 0 22 0 11 10 0 22 0 11
10 0 85 0 44 0 0 85 0 0 0 0 85 0 0 0 0 85 0 0 13 0 0 0 11 10 0 0 0 11 10 0 0 0 11
10 0 0 0 0 0 0 0 0 0 0 0 0 0 0 0 0 0 0 0 13 0 0 0 11 10 0 0 0 11 10 0 0 0 11
10 0 0 0 0 0 0 0 0 0 0 0 0 0 0 0 0 0 0 0 13 0 0 0 11 10 0 0 0 11 10 0 0 0 11
10 0 0 0 0 0 0 0 0 0 0 0 0 0 0 0 0 0 0 0 13 0 0 0 11 10 0 0 0 11 10 0 0 0 11
10 0 0 0 0 0 0 0 0 0 0 0 0 0 0 0 0 0 0 0 13 0 0 0 11 10 0 0 0 11 10 0 0 0 11
10 0 85 0 0 0 0 85 0 0 0 0 85 0 0 0 0 85 0 0 13 0 0 0 11 10 0 0 0 11 10 0 0 0 11
10 0 0 0 0 0 0 0 0 0 0 0 0 0 0 0 12 0 0 0 13 0 0 0 11 10 0 0 0 11 10 0 0 0 11
10 0 0 0 0 0 0 0 0 0 0 0 0 0 0 0 0 0 0 0 13 0 0 0 11 10 0 0 0 11 10 0 0 0 11
10 0 0 0 0 0 0 0 0 0 0 0 0 0 0 0 0 0 0 0 13 0 0 0 11 10 0 0 0 11 10 0 0 0 11
10 0 0 0 0 0 0 0 0 0 0 0 0 0 0 0 0 0 0 0 13 0 0 0 11 10 0 0 0 11 10 0 0 0 11
10 0 85 0 0 0 0 85 0 0 0 0 85 0 0 0 0 85 0 0 13 0 0 0 11 10 0 0 0 11 10 0 0 0 11
10 0 0 0 0 0 0 0 0 12 0 0 0 0 0 0 0 0 0 0 13 0 0 0 11 10 0 0 0 11 10 0 0 0 11
10 0 0 0 0 0 0 0 0 0 0 0 0 0 0 0 0 0 0 0 13 0 0 0 11 10 0 0 0 11 10 0 0 0 11
10 0 0 0 0 0 0 0 0 0 0 0 0 0 0 0 0 0 0 0 13 0 0 0 11 10 0 0 0 11 10 0 0 0 11
10 0 0 0 0 0 0 0 0 0 0 0 0 0 0 0 0 0 0 0 0 0 0 0 11 10 0 0 0 11 10 0 0 0 11
10 0 85 0 0 0 0 85 0 0 0 0 85 0 0 0 0 85 0 0 0 0 0 0 11 10 0 0 0 11 10 0 0 0 11
10 0 0 0 0 0 0 0 0 0 0 0 0 0 0 0 0 0 0 0 0 0 23 0 11 10 0 23 0 11 10 0 23 0 11
8 1 1 1 1 1 1 1 1 1 1 1 1 1 1 1 1 1 1 1 1 1 1 1 9 8 1 1 1 9 8 1 1 1 9
Star: 85 75 65