#CAMERA
NEAR -1.0
FAR 1.0
FOV 1.0
SPEED 10.0

Width: 32
Height: 18
Horizontal wall: 30
Player: 7
Enemy: 0
Target: 8
Spawn: 2
Obstacle: 0
2 2 2 2 2 2 2 2 2 2 2 2 2 2 2 2 2 2 2 2 2 2 2 2 2 2 2 2 2 2 2 2
6 1 1 1 1 1 1 1 1 1 1 1 1 1 1 1 1 1 1 1 1 1 1 1 1 1 1 1 1 1 1 7
10 44 0 0 0 0 0 0 0 0 0 0 0 0 0 13 13 44 0 0 0 0 0 0 0 0 0 0 0 0 0 11
10 0 0 0 0 0 0 0 0 0 0 0 0 0 0 13 13 0 0 0 0 0 0 0 0 0 0 0 0 0 0 11
10 0 0 0 0 0 0 0 0 0 12 0 0 0 0 13 13 0 0 0 0 0 0 0 0 0 0 0 0 0 0 11
10 0 0 0 0 22 0 13 0 0 0 0 0 0 0 13 13 0 0 0 0 22 0 13 13 13 0 0 0 0 0 11
10 0 0 0 0 22 0 13 23 0 0 0 0 0 0 13 13 0 0 0 22 0 0 0 0 0 0 0 0 0 0 11
10 0 0 0 0 0 0 13 0 22 0 0 0 0 0 13 13 0 0 0 12 0 0 0 0 0 0 0 0 0 0 11
10 0 0 0 0 0 0 0 0 0 0 0 0 0 0 13 13 0 0 0 0 0 0 0 0 0 0 0 0 0 0 11
20 13 13 13 13 13 13 13 13 13 13 13 13 13 13 13 13 13 13 13 13 13 13 13 13 13 13 13 13 13 13 21
10 44 0 0 0 0 0 0 0 0 0 0 0 0 0 13 13 44 0 0 0 0 0 0 0 0 0 0 0 0 0 11
10 0 0 0 0 22 12 0 0 0 0 0 0 0 0 13 13 0 0 0 0 0 0 0 0 0 23 0 0 0 0 11
10 0 0 0 0 0 0 0 0 0 0 0 0 0 0 13 13 0 0 0 0 0 0 0 0 0 0 0 0 0 0 11
10 0 0 0 13 0 22 0 0 0 0 0 0 0 0 13 13 0 0 0 0 22 0 13 0 0 0 0 0 0 0 11
10 0 0 0 13 0 0 0 0 13 0 0 0 0 0 13 13 0 0 0 0 0 13 0 0 0 0 0 0 0 0 11
10 0 0 0 13 13 13 13 0 0 0 0 0 0 0 13 13 0 0 0 0 13 0 0 0 0 0 0 0 0 0 11
10 0 0 0 0 0 0 0 0 0 0 0 0 0 0 13 13 0 0 0 0 0 0 0 0 0 0 0 0 0 0 11
8 1 1 1 1 1 1 1 1 1 1 1 1 1 1 1 1 1 1 1 1 1 1 1 1 1 1 1 1 1 1 9
Star: 90 60 30