#CAMERA
NEAR -1.0
FAR 1.0
FOV 1.0
SPEED 10.0

Width: 40
Height: 24
Horizontal wall: 169
Player: 2
Target: 2
Spawn: 0
Obstacle: 4
2 2 2 2 2 2 2 2 2 2 2 2 2 2 2 2 2 2 2 2 2 2 2 2 2 2 2 2 2 2 2 2 2 2 2 2 2 2 2 2 
2 2 2 2 2 2 2 2 2 2 2 2 2 2 2 2 2 2 2 2 2 2 2 2 2 2 2 2 2 2 2 2 2 2 2 2 2 2 2 2 
6 1 1 1 7 1 7 6 1 1 1 1 1 1 1 1 1 1 1 1 1 1 1 1 1 1 1 1 1 1 1 1 1 1 1 1 1 1 1 7
10 13 0 0 11 0 11 10 0 0 10 11 0 0 0 0 0 0 0 0 0 0 0 0 0 0 0 0 0 0 0 0 0 0 0 0 0 0 0 11
10 13 44 0 0 0 11 10 0 0 10 14 1 1 1 1 1 1 1 1 1 1 1 1 1 1 1 1 1 1 1 1 1 1 1 1 1 7 0 11
10 13 0 0 11 0 11 10 0 0 10 0 0 0 0 0 0 0 0 0 13 0 0 0 0 0 0 0 13 0 0 0 0 0 0 0 0 11 0 11
8 1 1 1 9 0 11 10 0 0 10 16 1 1 1 1 7 0 0 0 0 0 0 0 0 13 0 0 0 0 0 0 0 13 0 0 0 11 0 11
10 0 0 0 0 0 11 8 1 1 15 14 1 1 1 7 14 1 1 1 1 1 1 1 1 1 1 1 1 1 1 1 1 1 1 7 0 11 0 11
10 0 0 0 0 0 11 0 0 0 0 0 0 0 0 11 0 6 1 1 1 1 1 1 1 1 1 1 1 1 1 1 1 1 7 11 0 11 0 11
10 0 6 1 1 1 9 0 85 0 0 0 0 13 0 11 0 10 6 1 1 1 1 1 1 1 1 1 1 1 1 1 1 7 11 11 0 11 0 11
10 0 0 0 0 0 0 0 85 0 0 16 1 1 7 11 0 10 10 0 0 0 0 0 16 1 1 17 0 0 0 0 0 11 11 11 0 11 0 11
10 0 0 0 0 0 0 0 0 0 0 11 1 1 9 11 0 10 10 0 0 0 0 0 11 22 22 10 0 0 0 0 0 11 11 11 0 11 0 11
8 1 1 7 0 0 6 1 1 7 0 11 0 0 0 11 0 10 10 0 0 85 0 0 11 0 0 10 0 0 85 0 0 11 11 11 0 11 0 11
10 0 0 11 0 0 10 0 0 11 0 11 0 0 0 11 0 10 10 0 0 0 0 0 11 0 0 10 0 0 0 0 0 11 11 11 0 11 0 11
10 0 0 11 0 0 10 0 0 11 0 11 0 6 1 9 0 10 10 0 0 0 0 0 11 0 0 10 0 0 0 0 0 11 11 11 0 11 0 11
10 0 0 11 0 0 10 12 0 11 0 11 0 10 0 0 0 10 10 0 0 0 0 0 11 0 0 10 0 0 0 0 0 11 11 11 0 11 0 11
10 0 0 11 0 0 10 0 0 11 0 11 0 10 0 6 1 15 8 1 1 1 1 1 9 0 0 8 1 1 1 1 1 9 11 11 0 11 0 11
10 0 0 9 0 0 8 0 0 9 0 11 0 10 0 10 0 0 0 0 0 0 0 0 0 0 0 6 1 1 1 1 9 6 9 11 0 11 0 11
10 0 0 0 0 0 0 0 0 0 0 11 0 10 0 10 0 8 1 1 1 1 1 1 1 1 1 1 1 1 1 1 1 1 1 9 0 11 0 11
10 0 0 0 0 0 0 0 0 0 0 11 0 10 0 10 0 0 0 0 0 13 0 0 0 0 0 13 0 0 0 0 0 13 0 0 0 11 0 11
10 0 6 1 1 1 1 1 7 0 0 11 0 10 0 10 0 0 13 0 0 0 0 0 13 0 0 0 0 0 13 0 0 0 0 0 0 11 0 11
10 0 8 1 1 1 1 1 9 0 0 0 0 10 0 8 1 1 1 1 1 1 1 1 1 1 1 1 1 1 1 1 1 1 1 15 14 9 0 11
10 0 0 0 0 0 0 0 0 0 0 0 0 10 0 0 0 0 0 0 0 0 0 0 0 0 0 0 0 0 0 0 0 0 0 0 0 0 0 11
8 1 1 1 1 1 1 1 1 1 1 1 1 1 1 1 1 1 1 1 1 1 1 1 1 1 1 1 1 1 1 1 1 1 1 1 1 1 1 9
Star: 190 170 150