#CAMERA
NEAR -1.0
FAR 1.0
FOV 1.0
SPEED 10.0

Width: 32
Height: 18
Horizontal wall: 44
Player: 1
Target: 3
Spawn: 5
Obstacle: 2
2 2 2 2 2 2 2 2 2 2 2 2 2 6 1 1 1 1 7 2 2 2 2 2 2 2 2 2 2 2 2 2
2 2 2 2 2 2 2 2 2 2 2 2 2 10 13 24 23 13 11 2 2 2 2 2 2 2 2 2 2 2 2 2
2 2 2 2 2 2 2 2 2 2 2 2 2 10 0 13 13 0 11 2 2 2 2 2 2 2 2 2 2 2 2 2
2 2 2 2 2 2 2 2 2 2 2 2 2 8 1 1 1 1 9 2 2 2 2 2 2 2 2 2 2 2 2 2
2 2 2 2 2 2 2 2 2 2 2 2 2 2 2 2 2 2 2 2 2 2 2 2 2 2 2 2 2 2 2 2
2 2 2 2 2 2 6 1 1 1 1 1 1 1 7 2 2 6 1 1 1 1 1 1 1 7 2 2 2 2 2 2
2 2 2 2 2 2 10 0 0 0 0 0 0 0 11 2 2 10 0 0 0 0 0 0 0 11 2 2 2 2 2 2
2 2 2 2 2 2 10 0 0 0 23 0 0 0 11 2 2 10 0 0 0 0 0 0 0 11 2 2 2 2 2 2
2 2 2 2 2 2 10 0 0 0 0 0 0 0 14 1 1 15 0 0 22 0 0 0 0 11 2 2 2 2 2 2
2 2 2 2 2 2 10 0 0 85 0 0 0 0 0 0 0 0 0 0 0 0 0 85 0 11 2 2 2 2 2 2
2 2 2 2 2 2 10 0 0 0 0 0 0 0 0 0 0 0 0 0 0 0 23 0 0 11 2 2 2 2 2 2
2 2 2 2 2 2 10 0 0 0 0 0 0 0 16 1 1 17 0 0 0 0 0 0 0 11 2 2 2 2 2 2
2 2 2 2 2 2 10 0 0 0 0 0 0 0 11 1 1 10 0 0 0 0 0 0 0 11 2 2 2 2 2 2
2 2 2 2 2 2 10 0 0 0 23 0 0 0 11 2 2 10 0 0 0 0 0 0 0 11 2 2 2 2 2 2
2 2 2 2 2 2 10 0 0 0 0 0 0 0 11 2 2 10 0 0 0 23 0 0 0 11 2 2 2 2 2 2
2 2 2 2 2 2 10 0 0 22 0 0 0 0 11 2 2 10 0 0 0 0 0 0 0 11 2 2 2 2 2 2
2 2 2 2 2 2 10 0 0 0 0 0 0 0 11 2 2 10 0 0 0 0 0 0 0 11 2 2 2 2 2 2
2 2 2 2 2 2 8 1 1 1 1 1 1 1 9 2 2 8 1 1 1 1 1 1 1 9 2 2 2 2 2 2
Star: 48 42 36