#CAMERA
NEAR -1.0
FAR 1.0
FOV 1.0
SPEED 10.0

Width: 32
Height: 18
Horizontal wall: 82
Player: 1
Enemy: 0
Target: 4
Spawn: 4
Obstacle: 17
2 2 6 1 1 1 1 1 1 1 1 1 1 1 1 1 1 1 1 7 6 1 1 1 1 1 1 1 1 7 2 2
2 2 10 0 0 0 13 0 0 0 0 0 0 0 0 0 0 0 0 11 10 0 0 0 11 10 0 0 0 11 2 2
2 2 20 0 0 0 13 0 0 0 0 0 0 0 0 0 0 0 0 11 10 0 22 0 11 10 0 0 0 11 2 2
2 2 10 0 0 0 13 0 0 85 0 85 0 0 13 0 0 0 0 11 10 0 22 0 11 10 0 44 0 11 2 2 
2 2 10 0 22 0 13 0 0 0 0 0 0 0 13 0 0 23 0 11 10 0 0 0 11 10 0 0 0 11 2 2
2 2 10 0 0 0 13 0 0 85 0 85 0 0 13 0 0 0 0 11 10 85 0 85 11 10 0 85 0 11 2 2
2 2 20 0 0 0 0 0 0 0 0 0 0 0 13 0 0 0 0 11 10 0 0 0 11 10 0 0 0 11 2 2
2 2 10 0 0 0 0 0 0 0 0 0 0 0 13 0 0 0 0 11 10 0 0 0 11 10 0 0 0 11 2 2
2 2 8 1 1 1 1 1 1 1 1 1 1 1 1 1 1 1 1 9 10 85 0 85 11 10 0 85 0 11 2 2
2 2 6 1 1 1 1 1 1 1 1 1 1 1 1 1 1 1 1 7 10 0 0 0 11 10 0 0 0 11 2 2
2 2 10 0 0 0 0 0 0 0 0 0 0 0 13 0 0 0 0 11 10 0 0 0 11 10 0 0 0 11 2 2
2 2 20 0 0 0 0 0 0 0 0 0 0 0 13 0 0 0 0 11 10 85 0 85 14 15 0 85 0 11 2 2
2 2 10 0 0 0 13 0 0 85 0 85 0 0 13 0 0 0 0 11 10 0 0 0 0 0 0 0 0 11 2 2
2 2 10 0 22 0 13 0 0 0 0 0 0 0 13 0 0 23 0 11 10 0 0 0 0 0 0 23 0 11 2 2
2 2 10 0 0 0 13 0 0 85 0 85 0 0 13 0 0 0 0 11 10 0 0 0 0 0 0 23 0 11 2 2
2 2 20 0 0 0 13 0 0 0 0 0 0 0 0 0 0 0 0 11 10 0 0 0 0 0 0 0 0 11 2 2
2 2 10 0 0 0 13 0 0 0 0 0 0 0 0 0 0 0 0 11 10 0 0 0 0 0 0 0 0 11 2 2
2 2 8 1 1 1 1 1 1 1 1 1 1 1 1 1 1 1 1 9 8 1 1 1 1 1 1 1 1 9 2 2
Star: 80 70 60