#CAMERA
NEAR -1.0
FAR 1.0
FOV 1.0
SPEED 10.0

Width: 32
Height: 18
Horizontal wall: 18
Player: 1
Enemy: 1
Target: 1
Spawn: 0
Obstacle: 12
2 2 2 2 2 2 2 2 2 2 2 2 2 2 2 2 2 2 2 2 2 2 2 2 2 2 2 2 2 2 2 2
2 2 2 2 2 2 2 2 2 2 2 2 2 2 2 2 2 2 2 2 2 2 2 2 2 2 2 2 2 2 2 2
2 2 2 2 2 2 2 2 2 2 2 2 2 2 2 2 2 2 2 2 2 2 2 2 2 2 2 2 2 2 2 2
2 2 2 2 2 2 2 2 2 2 2 2 2 2 2 2 2 2 2 2 2 2 2 2 2 2 2 2 2 2 2 2
2 2 2 2 2 6 1 1 1 1 1 1 1 1 1 1 1 1 1 1 1 1 1 1 1 1 7 2 2 2 2 2
2 2 2 2 2 10 0 0 0 0 0 0 0 0 0 0 0 0 0 0 85 0 0 0 0 0 11 2 2 2 2 2
2 2 2 2 2 10 0 44 0 0 0 0 0 0 0 0 0 0 0 0 85 0 0 0 0 0 11 2 2 2 2 2
2 2 2 2 2 10 0 0 0 0 0 0 0 0 0 0 0 0 0 0 85 0 0 0 0 0 11 2 2 2 2 2
2 2 2 2 2 10 0 0 0 0 0 85 0 0 0 0 0 0 0 0 85 0 0 0 0 0 11 2 2 2 2 2
2 2 2 2 2 10 0 0 0 0 0 85 0 0 0 0 0 0 0 0 85 0 0 0 0 0 11 2 2 2 2 2
2 2 2 2 2 10 0 0 0 0 0 85 0 0 0 45 0 0 0 0 85 0 0 0 0 0 11 2 2 2 2 2
2 2 2 2 2 10 0 0 0 0 0 85 0 0 0 0 0 0 0 0 0 0 0 0 0 0 11 2 2 2 2 2
2 2 2 2 2 10 0 0 0 0 0 85 0 0 0 0 0 0 0 0 0 0 0 0 22 0 11 2 2 2 2 2
2 2 2 2 2 10 0 0 0 0 0 85 0 0 0 0 0 0 0 0 0 0 0 0 0 0 11 2 2 2 2 2
2 2 2 2 2 8 1 1 1 1 1 1 1 1 1 1 1 1 1 1 1 1 1 1 1 1 9 2 2 2 2 2
2 2 2 2 2 2 2 2 2 2 2 2 2 2 2 2 2 2 2 2 2 2 2 2 2 2 2 2 2 2 2 2
2 2 2 2 2 2 2 2 2 2 2 2 2 2 2 2 2 2 2 2 2 2 2 2 2 2 2 2 2 2 2 2
2 2 2 2 2 2 2 2 2 2 2 2 2 2 2 2 2 2 2 2 2 2 2 2 2 2 2 2 2 2 2 2
Star: 35 30 25