#CAMERA
NEAR -1.0
FAR 1.0
FOV 1.0
SPEED 10.0

Width: 32
Height: 18
Horizontal wall: 31
Player: 1
Enemy: 0
Target: 1
Spawn: 0
Obstacle: 3
2 2 2 2 2 2 2 2 2 2 2 2 2 2 2 2 2 2 2 2 2 2 2 2 2 2 2 2 2 2 2 2
2 2 2 2 2 2 2 2 2 2 2 2 2 2 2 2 2 2 2 2 2 2 2 2 2 2 2 2 2 2 2 2
2 2 2 2 2 2 2 2 2 2 2 2 2 2 2 2 2 2 2 2 2 2 2 2 2 2 2 2 2 2 2 2
2 2 2 2 2 2 2 2 2 2 2 2 2 2 2 2 2 6 1 1 1 1 1 7 2 2 2 2 2 2 2 2
2 2 2 2 2 2 2 2 2 2 2 2 2 2 2 2 2 10 0 0 0 0 13 11 2 2 2 2 2 2 2 2
2 2 2 2 2 2 2 2 2 2 2 2 2 2 2 2 2 10 0 13 0 0 13 11 2 2 2 2 2 2 2 2
2 2 2 2 2 2 2 2 2 2 2 2 2 2 2 2 2 10 0 13 0 0 13 11 2 2 2 2 2 2 2 2
2 2 2 2 2 2 2 2 2 2 2 2 2 2 2 2 2 10 0 13 0 0 0 11 2 2 2 2 2 2 2 2
2 2 2 2 2 2 2 2 2 2 6 1 6 7 6 1 1 15 16 1 1 1 0 11 2 2 2 2 2 2 2 2
2 2 2 2 2 2 2 2 2 2 10 22 10 11 10 0 0 0 11 0 0 0 0 11 2 2 2 2 2 2 2 2
2 2 2 2 2 2 2 2 2 2 10 0 10 14 15 85 16 1 9 0 16 1 1 9 2 2 2 2 2 2 2 2
2 2 2 2 2 2 2 2 2 2 10 0 10 44 0 0 11 0 0 0 11 2 2 2 2 2 2 2 2 2 2 2
2 2 2 2 2 2 2 2 2 2 10 0 8 1 1 1 9 0 85 85 11 2 2 2 2 2 2 2 2 2 2 2
2 2 2 2 2 2 2 2 2 2 10 0 0 0 0 0 0 0 0 0 11 2 2 2 2 2 2 2 2 2 2 2
2 2 2 2 2 2 2 2 2 2 8 1 1 1 1 1 1 1 1 1 9 2 2 2 2 2 2 2 2 2 2 2
2 2 2 2 2 2 2 2 2 2 2 2 2 2 2 2 2 2 2 2 2 2 2 2 2 2 2 2 2 2 2 2
2 2 2 2 2 2 2 2 2 2 2 2 2 2 2 2 2 2 2 2 2 2 2 2 2 2 2 2 2 2 2 2
2 2 2 2 2 2 2 2 2 2 2 2 2 2 2 2 2 2 2 2 2 2 2 2 2 2 2 2 2 2 2 2
Star: 50 45 40