#CAMERA
NEAR -1.0
FAR 1.0
FOV 1.0
SPEED 10.0

Width: 32
Height: 18
Horizontal wall: 14
Player: 6
Target: 6
Spawn: 0
Obstacle: 2
2 2 2 2 2 2 2 2 2 2 2 2 2 2 2 2 2 2 2 2 2 2 2 2 2 2 2 2 2 2 2 2
2 2 2 2 2 2 2 2 2 2 2 2 2 2 2 2 2 2 2 2 2 2 2 2 2 2 2 2 2 2 2 2
2 2 2 2 2 2 2 2 2 2 2 2 2 2 2 2 2 2 2 2 2 2 2 2 2 2 2 2 2 2 2 2
2 2 2 2 2 2 2 2 2 2 2 2 2 2 2 2 2 2 2 2 2 2 2 2 2 2 2 2 2 2 2 2
2 2 2 2 2 2 2 2 2 2 2 2 2 2 2 2 2 2 2 2 2 2 2 2 2 2 2 2 2 2 2 2
2 2 2 2 2 2 2 2 2 2 2 2 2 6 1 1 1 1 1 7 2 2 2 2 2 2 2 2 2 2 2 2
2 2 2 2 2 2 2 2 2 2 6 1 1 15 0 12 0 0 0 14 1 1 7 2 2 2 2 2 2 2 2 2
2 2 2 2 2 2 2 2 6 1 15 0 0 0 0 0 0 0 0 0 0 0 14 1 7 2 2 2 2 2 2 2
2 2 2 2 2 2 2 2 10 85 0 0 0 12 0 0 12 0 0 0 0 0 0 85 11 2 2 2 2 2 2 2
2 2 2 2 2 2 2 2 10 0 0 44 0 0 0 0 0 0 12 0 12 0 0 0 11 2 2 2 2 2 2 2
2 2 2 2 2 2 2 2 10 0 0 0 0 0 0 13 13 13 13 0 0 0 0 0 11 2 2 2 2 2 2 2
2 2 2 2 2 2 2 2 10 0 0 0 0 0 0 22 22 22 22 0 0 0 0 0 11 2 2 2 2 2 2 2
2 2 2 2 2 2 2 2 10 0 0 0 0 0 0 0 22 22 0 0 0 0 0 0 11 2 2 2 2 2 2 2
2 2 2 2 2 2 2 2 8 1 1 1 1 1 1 1 1 1 1 1 1 1 1 1 9 2 2 2 2 2 2 2
2 2 2 2 2 2 2 2 2 2 2 2 2 2 2 2 2 2 2 2 2 2 2 2 2 2 2 2 2 2 2 2
2 2 2 2 2 2 2 2 2 2 2 2 2 2 2 2 2 2 2 2 2 2 2 2 2 2 2 2 2 2 2 2
2 2 2 2 2 2 2 2 2 2 2 2 2 2 2 2 2 2 2 2 2 2 2 2 2 2 2 2 2 2 2 2
2 2 2 2 2 2 2 2 2 2 2 2 2 2 2 2 2 2 2 2 2 2 2 2 2 2 2 2 2 2 2 2
Star: 47 40 33