#CAMERA
NEAR -1.0
FAR 1.0
FOV 1.0
SPEED 10.0

Width: 32
Height: 18
Horizontal wall: 20
Player: 1
Enemy: 0
Target: 2
Spawn: 2
Obstacle: 0
2 2 2 2 2 2 2 2 2 2 2 2 2 2 2 2 2 2 2 2 2 2 2 2 2 2 2 2 2 2 2 2
2 2 2 2 2 2 2 2 2 2 2 2 2 2 2 2 2 2 2 2 2 2 2 2 2 2 2 2 2 2 2 2
2 2 2 2 2 2 2 2 2 2 2 2 2 2 2 2 2 2 2 2 2 2 2 2 2 2 2 2 2 2 2 2
2 2 2 2 2 2 2 6 1 1 1 1 1 1 1 1 1 1 1 1 1 1 1 1 7 2 2 2 2 2 2 2
2 2 2 2 2 2 2 10 0 0 0 0 0 0 0 0 0 0 0 0 0 0 0 0 11 2 2 2 2 2 2 2
2 2 2 2 2 2 2 10 0 0 0 0 0 0 0 0 0 0 0 0 0 0 0 0 11 2 2 2 2 2 2 2
2 2 2 2 2 2 2 10 0 22 44 0 0 0 0 0 0 0 0 0 23 0 0 0 11 2 2 2 2 2 2 2
2 2 2 2 2 2 2 10 0 0 0 0 0 0 0 0 0 0 0 0 0 0 0 0 11 2 2 2 2 2 2 2
2 2 2 2 2 2 2 10 0 0 0 0 0 0 0 0 0 0 0 0 0 0 0 0 11 2 2 2 2 2 2 2
2 2 2 2 2 2 2 20 13 13 13 13 13 13 13 13 13 13 13 13 13 13 13 13 21 2 2 2 2 2 2 2
2 2 2 2 2 2 2 10 0 0 0 0 0 0 0 0 0 0 0 0 0 0 0 0 11 2 2 2 2 2 2 2
2 2 2 2 2 2 2 10 0 22 0 0 0 0 0 0 0 0 0 0 23 0 0 0 11 2 2 2 2 2 2 2
2 2 2 2 2 2 2 10 0 0 0 0 0 0 0 0 0 0 0 0 0 0 0 0 11 2 2 2 2 2 2 2
2 2 2 2 2 2 2 10 0 0 0 0 0 0 0 0 0 0 0 0 0 0 0 0 11 2 2 2 2 2 2 2
2 2 2 2 2 2 2 8 1 1 1 1 1 1 1 1 1 1 1 1 1 1 1 1 9 2 2 2 2 2 2 2
2 2 2 2 2 2 2 2 2 2 2 2 2 2 2 2 2 2 2 2 2 2 2 2 2 2 2 2 2 2 2 2
2 2 2 2 2 2 2 2 2 2 2 2 2 2 2 2 2 2 2 2 2 2 2 2 2 2 2 2 2 2 2 2
2 2 2 2 2 2 2 2 2 2 2 2 2 2 2 2 2 2 2 2 2 2 2 2 2 2 2 2 2 2 2 2
Star: 35 30 25