#CAMERA
NEAR -1.0
FAR 1.0
FOV 1.0
SPEED 10.0

Width: 32
Height: 18
Horizontal wall: 10
Player: 5
Target: 5
Spawn: 0
Obstacle: 6
2 2 2 2 2 2 2 2 2 2 2 2 2 2 2 2 2 2 2 2 2 2 2 2 2 2 2 2 2 2 2 2
2 2 2 2 2 2 2 2 2 2 2 2 2 2 2 2 2 2 2 2 2 2 2 2 2 2 2 2 2 2 2 2
2 2 2 2 2 2 2 2 2 2 2 2 2 2 2 2 2 2 2 2 2 2 2 2 2 2 2 2 2 2 2 2
2 2 2 2 2 2 2 2 2 2 2 2 2 2 2 2 2 2 2 2 2 2 2 2 2 2 2 2 2 2 2 2
2 2 2 2 2 2 2 2 2 2 2 2 2 2 2 2 2 2 2 2 2 2 2 2 2 2 2 2 2 2 2 2
2 2 2 2 2 2 2 2 2 2 2 2 2 2 2 2 2 2 2 2 2 2 2 2 2 2 2 2 2 2 2 2
2 2 2 2 2 2 2 2 6 1 1 1 1 1 1 1 1 1 1 1 1 1 1 2 2 2 2 2 2 2 2 2
2 2 2 2 2 2 2 2 10 0 0 0 12 0 0 0 0 12 85 0 0 0 11 2 2 2 2 2 2 2 2 2
2 2 2 2 2 2 2 2 10 0 0 0 0 0 85 0 22 0 85 0 0 12 0 1 7 2 2 2 2 2 2 2
2 2 2 2 2 2 2 2 10 0 0 0 0 0 85 22 24 22 0 0 0 0 0 0 11 2 2 2 2 2 2 2
2 2 2 2 2 2 2 2 20 13 13 13 13 0 85 0 22 0 0 0 0 0 0 0 11 2 2 2 2 2 2 2
2 2 2 2 2 2 2 2 10 0 0 0 0 0 85 0 0 0 12 0 0 0 0 0 11 2 2 2 2 2 2 2
2 2 2 2 2 2 2 2 10 0 0 0 0 0 1 1 1 1 1 1 1 1 1 1 9 2 2 2 2 2 2 2
2 2 2 2 2 2 2 2 8 1 1 1 1 9 2 2 2 2 2 2 2 2 2 2 2 2 2 2 2 2 2 2
2 2 2 2 2 2 2 2 2 2 2 2 2 2 2 2 2 2 2 2 2 2 2 2 2 2 2 2 2 2 2 2
2 2 2 2 2 2 2 2 2 2 2 2 2 2 2 2 2 2 2 2 2 2 2 2 2 2 2 2 2 2 2 2
2 2 2 2 2 2 2 2 2 2 2 2 2 2 2 2 2 2 2 2 2 2 2 2 2 2 2 2 2 2 2 2
2 2 2 2 2 2 2 2 2 2 2 2 2 2 2 2 2 2 2 2 2 2 2 2 2 2 2 2 2 2 2 2
Star: 36 30 24