#CAMERA
NEAR -1.0
FAR 1.0
FOV 1.0
SPEED 10.0

Width: 32
Height: 18
Horizontal wall: 24
Player: 2
Target: 3
Spawn: 3
Obstacle: 12
2 2 2 2 2 2 2 2 2 2 2 2 2 2 2 2 2 2 2 2 2 2 2 2 2 2 2 2 2 2 2 2
2 2 2 2 2 2 2 2 2 2 2 2 2 2 2 2 2 2 2 2 2 2 2 2 2 2 2 2 2 2 2 2
2 2 2 2 2 6 1 1 1 1 1 1 1 1 1 1 1 1 1 1 1 1 1 1 1 1 7 2 2 2 2 2
2 2 2 2 2 10 0 0 0 0 0 0 0 0 0 0 0 0 0 0 0 0 0 0 0 0 11 2 2 2 2 2
2 2 2 2 2 10 0 0 0 0 0 0 0 0 0 0 0 0 0 0 0 0 0 0 0 0 11 2 2 2 2 2
2 2 2 2 2 10 0 0 85 0 23 0 0 0 12 0 0 0 0 0 0 0 0 85 0 0 11 2 2 2 2 2
2 2 2 2 2 10 0 0 0 0 0 85 0 0 0 0 0 0 0 0 85 0 0 0 0 0 11 2 2 2 2 2
2 2 2 2 2 10 0 0 0 0 0 0 0 0 85 0 0 85 0 0 0 23 0 0 0 0 11 2 2 2 2 2
2 2 2 2 2 10 0 0 0 0 0 22 0 0 0 0 0 0 0 0 0 0 0 0 0 0 11 2 2 2 2 2
2 2 2 2 2 10 0 0 44 0 0 0 0 0 0 0 0 0 0 0 0 0 0 0 0 0 11 2 2 2 2 2
2 2 2 2 2 10 0 0 0 0 0 0 0 0 85 0 0 85 0 0 0 0 22 0 0 0 11 2 2 2 2 2
2 2 2 2 2 10 0 0 0 0 0 85 0 0 0 0 0 0 23 0 85 0 0 0 0 0 11 2 2 2 2 2
2 2 2 2 2 10 0 0 85 0 22 0 0 0 0 0 0 0 0 0 0 0 0 85 0 0 11 2 2 2 2 2
2 2 2 2 2 10 0 0 0 0 0 0 0 0 0 0 0 0 0 0 0 0 0 0 0 0 11 2 2 2 2 2
2 2 2 2 2 10 0 0 0 0 0 0 0 0 0 0 0 0 0 0 0 0 0 0 0 0 11 2 2 2 2 2
2 2 2 2 2 8 1 1 1 1 1 1 1 1 1 1 1 1 1 1 1 1 1 1 1 1 9 2 2 2 2 2
2 2 2 2 2 2 2 2 2 2 2 2 2 2 2 2 2 2 2 2 2 2 2 2 2 2 2 2 2 2 2 2
2 2 2 2 2 2 2 2 2 2 2 2 2 2 2 2 2 2 2 2 2 2 2 2 2 2 2 2 2 2 2 2
Star: 60 50 40