#CAMERA
NEAR -1.0
FAR 1.0
FOV 1.0
SPEED 10.0

Width: 32
Height: 18
Horizontal wall: 48
Player: 3
Target: 5
Spawn: 3
Obstacle: 3
2 2 2 2 2 2 2 2 2 2 2 2 2 6 1 1 1 1 7 2 2 2 2 2 2 2 2 2 2 2 2 2
2 2 2 2 2 2 2 2 2 2 2 2 2 10 13 24 23 13 11 2 2 2 2 2 2 2 2 2 2 2 2 2
2 2 2 2 2 2 2 2 2 2 2 2 2 10 0 13 13 0 11 2 2 2 2 2 2 2 2 2 2 2 2 2
2 2 2 2 2 2 2 2 2 2 2 2 2 8 1 1 1 1 9 2 2 2 2 2 2 2 2 2 2 2 2 2
2 2 2 2 2 2 6 1 1 1 1 1 1 1 7 2 2 6 1 1 1 1 1 1 1 7 2 2 2 2 2 2
2 2 2 2 2 2 10 0 0 0 0 0 0 0 11 2 2 10 0 0 0 0 0 0 0 11 2 2 2 2 2 2
2 2 2 2 2 2 10 0 0 0 0 0 0 12 11 2 2 10 0 0 0 0 0 0 0 11 2 2 2 2 2 2
2 2 2 2 2 2 10 0 0 0 23 0 0 0 11 2 2 10 0 0 0 0 0 0 0 11 2 2 2 2 2 2
2 2 2 2 2 2 10 0 0 0 0 0 0 0 11 1 1 10 0 0 0 0 12 0 0 11 2 2 2 2 2 2
2 2 2 2 2 2 10 0 0 0 0 22 0 0 11 0 0 10 0 0 0 0 0 0 0 21 2 2 2 2 2 2
2 2 2 2 2 2 10 0 0 0 0 22 0 0 11 0 0 10 0 0 0 0 0 0 0 11 2 2 2 2 2 2
2 2 2 2 2 2 10 0 0 0 0 0 0 0 11 1 1 10 0 0 23 0 22 0 0 11 2 2 2 2 2 2
2 2 2 2 2 2 10 0 0 0 0 85 0 0 11 1 1 10 0 0 0 0 0 0 0 11 2 2 2 2 2 2
2 2 2 2 2 2 10 0 0 0 0 0 0 0 11 2 2 10 0 0 85 22 0 0 0 11 2 2 2 2 2 2
2 2 2 2 2 2 10 0 0 0 0 0 0 0 11 2 2 10 0 0 0 0 0 0 0 11 2 2 2 2 2 2
2 2 2 2 2 2 10 0 0 0 0 0 0 0 11 2 2 10 0 85 0 0 0 0 0 11 2 2 2 2 2 2
2 2 2 2 2 2 8 1 1 1 1 1 1 1 9 2 2 8 1 1 1 1 1 1 1 9 2 2 2 2 2 2
2 2 2 2 2 2 8 1 1 1 1 1 1 1 9 2 2 8 1 1 1 1 1 1 1 9 2 2 2 2 2 2
Star: 30 25 20